17
17
1111111...1111111
1...............1
1...............1
1...............1
1...............1
1...............1
1...............1
.................
.................
.................
0...............0
0...............0
0...............1
0...............0
0...............0
0...............0
0000000...0000000